#--------------#
| |     |--|   |
| |-| | |-   | |
| | | |-|  |---|
|       |      |
|---| |    |-  |
|     |  | |  -|
#--------------#
