#-----------------------------#
|      |           |-        -|
|----| | | |--| |  |  |----|  |
|    |   |-|    |--|     |    |
| -|   |   |--|  | -| |--|--| |
|----|-| | |  |-   |  |  |  | |
| |      |--| |--|      -     |
| | |--|         | |  |   |---|
|   |    | |---|      |---|   |
| - | -| |--|  | |-|  | | | | |
|      |    | -|  |         |-|
| |--|   |-    | -| | | | | | |
|      | |  |-      | |   |   |
#-----------------------------#