#――――――――――――――――――――――――――――――――――――――――#
|        |  |      |   |            | |  |
| | | |――|  |  |-|   |   |-| |-| |  |   -|
| | |      -|--| | |---|   | | |-|----|  |
| | |―――|   |  |-|   | |-|          |    |
| |     | |        --|     -|-|---| |--| |
| |―| ――|―――| | |-   |--|   |            |
|  -|   |   |---|  | | -| |-|--| |-| |-| |
|-    |---| | |    --|           |       |
|――|            |--|    |  |  |--|-| --| |
|  |――|----|  |-|  |--| |---|    |       |
|  | -|  |         |          |--|---|   |
| -|    -|-|--| |--|  |---|-|     |    | |
|     |--| |    |    |-|    |  |--|--| |-|
|- |         |--| -| | | -|-|     | -| | |
|  |- | -| | |  |  | |         |         |
|- |  |  |---|- |--|-|- | -| | |-  |  | -|
|--|--|    | |     | |  |  |---|  -|--|  |
|       |  |   -|-     -|-     |-     |- |
#――――――――――――――――――――――――――――――――――――――――#